//MAP CONVERTED BY dmm2tgm.py THIS HEADER COMMENT PREVENTS RECONVERSION, DO NOT REMOVE
"es" = (
/turf/template_noop,
/area/template_noop)

(1,1,1) = {"
es
es
es
es
es
es
es
es
es
es
es
es
es
es
es
es
es
es
es
es
es
es
es
es
es
es
es
es
"}
(2,1,1) = {"
es
es
es
es
es
es
es
es
es
es
es
es
es
es
es
es
es
es
es
es
es
es
es
es
es
es
es
es
"}
(3,1,1) = {"
es
es
es
es
es
es
es
es
es
es
es
es
es
es
es
es
es
es
es
es
es
es
es
es
es
es
es
es
"}
(4,1,1) = {"
es
es
es
es
es
es
es
es
es
es
es
es
es
es
es
es
es
es
es
es
es
es
es
es
es
es
es
es
"}
(5,1,1) = {"
es
es
es
es
es
es
es
es
es
es
es
es
es
es
es
es
es
es
es
es
es
es
es
es
es
es
es
es
"}
(6,1,1) = {"
es
es
es
es
es
es
es
es
es
es
es
es
es
es
es
es
es
es
es
es
es
es
es
es
es
es
es
es
"}
(7,1,1) = {"
es
es
es
es
es
es
es
es
es
es
es
es
es
es
es
es
es
es
es
es
es
es
es
es
es
es
es
es
"}
(8,1,1) = {"
es
es
es
es
es
es
es
es
es
es
es
es
es
es
es
es
es
es
es
es
es
es
es
es
es
es
es
es
"}
(9,1,1) = {"
es
es
es
es
es
es
es
es
es
es
es
es
es
es
es
es
es
es
es
es
es
es
es
es
es
es
es
es
"}
(10,1,1) = {"
es
es
es
es
es
es
es
es
es
es
es
es
es
es
es
es
es
es
es
es
es
es
es
es
es
es
es
es
"}
(11,1,1) = {"
es
es
es
es
es
es
es
es
es
es
es
es
es
es
es
es
es
es
es
es
es
es
es
es
es
es
es
es
"}
(12,1,1) = {"
es
es
es
es
es
es
es
es
es
es
es
es
es
es
es
es
es
es
es
es
es
es
es
es
es
es
es
es
"}
(13,1,1) = {"
es
es
es
es
es
es
es
es
es
es
es
es
es
es
es
es
es
es
es
es
es
es
es
es
es
es
es
es
"}
(14,1,1) = {"
es
es
es
es
es
es
es
es
es
es
es
es
es
es
es
es
es
es
es
es
es
es
es
es
es
es
es
es
"}
(15,1,1) = {"
es
es
es
es
es
es
es
es
es
es
es
es
es
es
es
es
es
es
es
es
es
es
es
es
es
es
es
es
"}
(16,1,1) = {"
es
es
es
es
es
es
es
es
es
es
es
es
es
es
es
es
es
es
es
es
es
es
es
es
es
es
es
es
"}
(17,1,1) = {"
es
es
es
es
es
es
es
es
es
es
es
es
es
es
es
es
es
es
es
es
es
es
es
es
es
es
es
es
"}
(18,1,1) = {"
es
es
es
es
es
es
es
es
es
es
es
es
es
es
es
es
es
es
es
es
es
es
es
es
es
es
es
es
"}
(19,1,1) = {"
es
es
es
es
es
es
es
es
es
es
es
es
es
es
es
es
es
es
es
es
es
es
es
es
es
es
es
es
"}
(20,1,1) = {"
es
es
es
es
es
es
es
es
es
es
es
es
es
es
es
es
es
es
es
es
es
es
es
es
es
es
es
es
"}
(21,1,1) = {"
es
es
es
es
es
es
es
es
es
es
es
es
es
es
es
es
es
es
es
es
es
es
es
es
es
es
es
es
"}
(22,1,1) = {"
es
es
es
es
es
es
es
es
es
es
es
es
es
es
es
es
es
es
es
es
es
es
es
es
es
es
es
es
"}
(23,1,1) = {"
es
es
es
es
es
es
es
es
es
es
es
es
es
es
es
es
es
es
es
es
es
es
es
es
es
es
es
es
"}
(24,1,1) = {"
es
es
es
es
es
es
es
es
es
es
es
es
es
es
es
es
es
es
es
es
es
es
es
es
es
es
es
es
"}
(25,1,1) = {"
es
es
es
es
es
es
es
es
es
es
es
es
es
es
es
es
es
es
es
es
es
es
es
es
es
es
es
es
"}
(26,1,1) = {"
es
es
es
es
es
es
es
es
es
es
es
es
es
es
es
es
es
es
es
es
es
es
es
es
es
es
es
es
"}
(27,1,1) = {"
es
es
es
es
es
es
es
es
es
es
es
es
es
es
es
es
es
es
es
es
es
es
es
es
es
es
es
es
"}
(28,1,1) = {"
es
es
es
es
es
es
es
es
es
es
es
es
es
es
es
es
es
es
es
es
es
es
es
es
es
es
es
es
"}
(29,1,1) = {"
es
es
es
es
es
es
es
es
es
es
es
es
es
es
es
es
es
es
es
es
es
es
es
es
es
es
es
es
"}
(30,1,1) = {"
es
es
es
es
es
es
es
es
es
es
es
es
es
es
es
es
es
es
es
es
es
es
es
es
es
es
es
es
"}
(31,1,1) = {"
es
es
es
es
es
es
es
es
es
es
es
es
es
es
es
es
es
es
es
es
es
es
es
es
es
es
es
es
"}
(32,1,1) = {"
es
es
es
es
es
es
es
es
es
es
es
es
es
es
es
es
es
es
es
es
es
es
es
es
es
es
es
es
"}
(33,1,1) = {"
es
es
es
es
es
es
es
es
es
es
es
es
es
es
es
es
es
es
es
es
es
es
es
es
es
es
es
es
"}
