//MAP CONVERTED BY dmm2tgm.py THIS HEADER COMMENT PREVENTS RECONVERSION, DO NOT REMOVE
"c" = (
/turf/template_noop,
/area/template_noop)

(1,1,1) = {"
c
c
c
c
c
c
c
c
c
c
c
c
c
c
c
c
c
c
c
c
"}
(2,1,1) = {"
c
c
c
c
c
c
c
c
c
c
c
c
c
c
c
c
c
c
c
c
"}
(3,1,1) = {"
c
c
c
c
c
c
c
c
c
c
c
c
c
c
c
c
c
c
c
c
"}
(4,1,1) = {"
c
c
c
c
c
c
c
c
c
c
c
c
c
c
c
c
c
c
c
c
"}
(5,1,1) = {"
c
c
c
c
c
c
c
c
c
c
c
c
c
c
c
c
c
c
c
c
"}
(6,1,1) = {"
c
c
c
c
c
c
c
c
c
c
c
c
c
c
c
c
c
c
c
c
"}
(7,1,1) = {"
c
c
c
c
c
c
c
c
c
c
c
c
c
c
c
c
c
c
c
c
"}
(8,1,1) = {"
c
c
c
c
c
c
c
c
c
c
c
c
c
c
c
c
c
c
c
c
"}
(9,1,1) = {"
c
c
c
c
c
c
c
c
c
c
c
c
c
c
c
c
c
c
c
c
"}
(10,1,1) = {"
c
c
c
c
c
c
c
c
c
c
c
c
c
c
c
c
c
c
c
c
"}
(11,1,1) = {"
c
c
c
c
c
c
c
c
c
c
c
c
c
c
c
c
c
c
c
c
"}
(12,1,1) = {"
c
c
c
c
c
c
c
c
c
c
c
c
c
c
c
c
c
c
c
c
"}
(13,1,1) = {"
c
c
c
c
c
c
c
c
c
c
c
c
c
c
c
c
c
c
c
c
"}
(14,1,1) = {"
c
c
c
c
c
c
c
c
c
c
c
c
c
c
c
c
c
c
c
c
"}
(15,1,1) = {"
c
c
c
c
c
c
c
c
c
c
c
c
c
c
c
c
c
c
c
c
"}
(16,1,1) = {"
c
c
c
c
c
c
c
c
c
c
c
c
c
c
c
c
c
c
c
c
"}
(17,1,1) = {"
c
c
c
c
c
c
c
c
c
c
c
c
c
c
c
c
c
c
c
c
"}
(18,1,1) = {"
c
c
c
c
c
c
c
c
c
c
c
c
c
c
c
c
c
c
c
c
"}
(19,1,1) = {"
c
c
c
c
c
c
c
c
c
c
c
c
c
c
c
c
c
c
c
c
"}
(20,1,1) = {"
c
c
c
c
c
c
c
c
c
c
c
c
c
c
c
c
c
c
c
c
"}
