//MAP CONVERTED BY dmm2tgm.py THIS HEADER COMMENT PREVENTS RECONVERSION, DO NOT REMOVE
"mv" = (
/turf/template_noop,
/area/template_noop)

(1,1,1) = {"
mv
mv
mv
mv
mv
mv
mv
mv
mv
mv
mv
mv
mv
mv
mv
mv
mv
mv
mv
mv
mv
mv
mv
"}
(2,1,1) = {"
mv
mv
mv
mv
mv
mv
mv
mv
mv
mv
mv
mv
mv
mv
mv
mv
mv
mv
mv
mv
mv
mv
mv
"}
(3,1,1) = {"
mv
mv
mv
mv
mv
mv
mv
mv
mv
mv
mv
mv
mv
mv
mv
mv
mv
mv
mv
mv
mv
mv
mv
"}
(4,1,1) = {"
mv
mv
mv
mv
mv
mv
mv
mv
mv
mv
mv
mv
mv
mv
mv
mv
mv
mv
mv
mv
mv
mv
mv
"}
(5,1,1) = {"
mv
mv
mv
mv
mv
mv
mv
mv
mv
mv
mv
mv
mv
mv
mv
mv
mv
mv
mv
mv
mv
mv
mv
"}
(6,1,1) = {"
mv
mv
mv
mv
mv
mv
mv
mv
mv
mv
mv
mv
mv
mv
mv
mv
mv
mv
mv
mv
mv
mv
mv
"}
(7,1,1) = {"
mv
mv
mv
mv
mv
mv
mv
mv
mv
mv
mv
mv
mv
mv
mv
mv
mv
mv
mv
mv
mv
mv
mv
"}
(8,1,1) = {"
mv
mv
mv
mv
mv
mv
mv
mv
mv
mv
mv
mv
mv
mv
mv
mv
mv
mv
mv
mv
mv
mv
mv
"}
(9,1,1) = {"
mv
mv
mv
mv
mv
mv
mv
mv
mv
mv
mv
mv
mv
mv
mv
mv
mv
mv
mv
mv
mv
mv
mv
"}
(10,1,1) = {"
mv
mv
mv
mv
mv
mv
mv
mv
mv
mv
mv
mv
mv
mv
mv
mv
mv
mv
mv
mv
mv
mv
mv
"}
(11,1,1) = {"
mv
mv
mv
mv
mv
mv
mv
mv
mv
mv
mv
mv
mv
mv
mv
mv
mv
mv
mv
mv
mv
mv
mv
"}
(12,1,1) = {"
mv
mv
mv
mv
mv
mv
mv
mv
mv
mv
mv
mv
mv
mv
mv
mv
mv
mv
mv
mv
mv
mv
mv
"}
(13,1,1) = {"
mv
mv
mv
mv
mv
mv
mv
mv
mv
mv
mv
mv
mv
mv
mv
mv
mv
mv
mv
mv
mv
mv
mv
"}
(14,1,1) = {"
mv
mv
mv
mv
mv
mv
mv
mv
mv
mv
mv
mv
mv
mv
mv
mv
mv
mv
mv
mv
mv
mv
mv
"}
(15,1,1) = {"
mv
mv
mv
mv
mv
mv
mv
mv
mv
mv
mv
mv
mv
mv
mv
mv
mv
mv
mv
mv
mv
mv
mv
"}
(16,1,1) = {"
mv
mv
mv
mv
mv
mv
mv
mv
mv
mv
mv
mv
mv
mv
mv
mv
mv
mv
mv
mv
mv
mv
mv
"}
(17,1,1) = {"
mv
mv
mv
mv
mv
mv
mv
mv
mv
mv
mv
mv
mv
mv
mv
mv
mv
mv
mv
mv
mv
mv
mv
"}
(18,1,1) = {"
mv
mv
mv
mv
mv
mv
mv
mv
mv
mv
mv
mv
mv
mv
mv
mv
mv
mv
mv
mv
mv
mv
mv
"}
(19,1,1) = {"
mv
mv
mv
mv
mv
mv
mv
mv
mv
mv
mv
mv
mv
mv
mv
mv
mv
mv
mv
mv
mv
mv
mv
"}
(20,1,1) = {"
mv
mv
mv
mv
mv
mv
mv
mv
mv
mv
mv
mv
mv
mv
mv
mv
mv
mv
mv
mv
mv
mv
mv
"}
(21,1,1) = {"
mv
mv
mv
mv
mv
mv
mv
mv
mv
mv
mv
mv
mv
mv
mv
mv
mv
mv
mv
mv
mv
mv
mv
"}
(22,1,1) = {"
mv
mv
mv
mv
mv
mv
mv
mv
mv
mv
mv
mv
mv
mv
mv
mv
mv
mv
mv
mv
mv
mv
mv
"}
(23,1,1) = {"
mv
mv
mv
mv
mv
mv
mv
mv
mv
mv
mv
mv
mv
mv
mv
mv
mv
mv
mv
mv
mv
mv
mv
"}
(24,1,1) = {"
mv
mv
mv
mv
mv
mv
mv
mv
mv
mv
mv
mv
mv
mv
mv
mv
mv
mv
mv
mv
mv
mv
mv
"}
(25,1,1) = {"
mv
mv
mv
mv
mv
mv
mv
mv
mv
mv
mv
mv
mv
mv
mv
mv
mv
mv
mv
mv
mv
mv
mv
"}
(26,1,1) = {"
mv
mv
mv
mv
mv
mv
mv
mv
mv
mv
mv
mv
mv
mv
mv
mv
mv
mv
mv
mv
mv
mv
mv
"}
(27,1,1) = {"
mv
mv
mv
mv
mv
mv
mv
mv
mv
mv
mv
mv
mv
mv
mv
mv
mv
mv
mv
mv
mv
mv
mv
"}
(28,1,1) = {"
mv
mv
mv
mv
mv
mv
mv
mv
mv
mv
mv
mv
mv
mv
mv
mv
mv
mv
mv
mv
mv
mv
mv
"}
(29,1,1) = {"
mv
mv
mv
mv
mv
mv
mv
mv
mv
mv
mv
mv
mv
mv
mv
mv
mv
mv
mv
mv
mv
mv
mv
"}
(30,1,1) = {"
mv
mv
mv
mv
mv
mv
mv
mv
mv
mv
mv
mv
mv
mv
mv
mv
mv
mv
mv
mv
mv
mv
mv
"}
(31,1,1) = {"
mv
mv
mv
mv
mv
mv
mv
mv
mv
mv
mv
mv
mv
mv
mv
mv
mv
mv
mv
mv
mv
mv
mv
"}
(32,1,1) = {"
mv
mv
mv
mv
mv
mv
mv
mv
mv
mv
mv
mv
mv
mv
mv
mv
mv
mv
mv
mv
mv
mv
mv
"}
